1111511111111
100F0000000C1
1000011111001
1P0X11E000001
1112111111111