11111111110001
000010000100C1
10001111111001
0P0011E0010001
11101111111111